+--+--+---+---+
|             |
+   +--+   +  +
|   |      |  |
+   +   +--+--+
|   |         |
+   +--+--+   +
|         | w |
+--+--+---+---+
