+--+--+--+--+--+--+--+--+--+
|                          |
+  +--+--+--+  +--+--+--+  +
|  |        |  |        |  |
+  +  +--+  +  +  +--+  +  +
|  |  |  |  |  |  |  e  |  |
+  +  +  +  +  +  +--+  +  +
|  |  |  |  |  |     |  |  |
+  +  +  +  +  +--+  +  +  +
|     |  |  |     |  |     |
+--+  +  +  +--+  +  +--+--+
|  |  |  |     |  |        |
+  +  +  +--+  +  +--+--+  +
|  |  |  e  |  |        |  |
+  +  +--+--+  +  +--+  +  +
|  |           |  |  e  |  |
+  +--+--+--+--+  +--+  +  +
|                       |  w
+--+--+--+--+--+--+--+--+--+
