+--+--+--+--+
|   e       |
+  +--+  +  +
|  |     |  |
+  +  +--+--+
|  |        |
+  +--+--+  +
|        | w|
+--+--+--+--+
