+--+--+--+--+--+--+--+--+
|                       |
+  +--+--+  +--+--+--+  +
|        |  |        |  |
+--+--+  +  +  +--+  +  +
|        |  |  |  e  |  |
+  +--+--+  +  +--+  +  +
|  |        |     |  |  |
+  +  +--+--+--+  +  +  +
|  |  |        |  |     |
+  +  +  +--+  +  +--+--+
|  |  |  |  e  |        |
+  +  +  +--+--+--+--+  +
|  |  |              |  w
+  +  +--+--+--+--+  +--+
|                    |  |
+--+--+--+--+--+--+--+--+
