+--+--+--+--+
|           |
+  +--+  +  +
|  |     |  |
+  +  +--+--+
|  |        |
+  +--+--+  +
|        | g|
+--+--+--+--+
